
unsigned char turkishC[]
{0,0,0,0,0,0,0,0,0,0,0,0,0,0,0,0,0,0,0,0,0,0,0,0,1,0,0,0,0,0,0,0,0,0,0,0,0,0,0,0,0,0,0,0,0,0,0,0,0,0,0,0,0,0,0,0,0,0,0,0,0,0,0,0,0,0,0,0,0,0,0,0,1,0,0,0,0,43,156,224,248,255,254,251,232,183,81,0,1,0,0,0,0,0,0,0,1,0,0,0,0,0,0,0,1,0,0,0,132,240,255,255,255,255,255,255,255,254,242,93,1,1,0,1,0,1,0,0,0,0,0,0,0,0,0,1,0,0,0,161,251,255,255,240,190,162,162,179,233,254,242,93,0,0,0,0,0,1,0,0,0,1,0,0,0,0,0,0,0,0,120,246,255,254,187,28,0,1,0,0,0,106,213,93,0,0,0,0,0,0,0,1,0,1,0,0,0,0,0,0,0,38,216,255,255,203,12,0,0,0,0,0,0,0,28,13,0,0,0,0,0,0,0,0,0,0,0,0,0,0,1,0,0,120,247,255,243,106,0,0,0,0,1,0,0,0,0,0,0,0,0,0,0,0,0,0,0,0,0,1,0,0,0,0,0,188,255,255,212,13,0,0,0,0,0,0,0,0,0,0,1,1,0,0,0,0,0,1,0,0,0,0,0,0,0,1,38,219,255,255,177,0,0,0,0,0,0,0,0,0,0,0,0,0,1,0,0,0,0,0,0,0,0,0,0,0,0,0,77,233,255,252,148,0,1,0,0,0,0,0,0,0,1,0,0,0,0,0,0,0,0,0,0,0,0,0,0,0,0,0,93,242,255,249,130,0,0,0,0,0,0,0,0,0,0,0,0,0,0,0,1,0,0,0,0,0,0,0,0,0,0,0,93,242,255,249,130,0,0,0,0,0,0,0,0,1,0,0,0,0,1,0,0,1,0,0,0,0,0,0,0,0,0,0,93,242,255,249,130,0,0,0,0,0,0,0,0,1,0,0,0,0,0,0,0,0,0,0,0,0,0,0,0,0,0,0,93,242,255,249,130,0,0,0,0,0,0,0,0,0,0,0,1,1,0,0,0,0,0,0,0,0,0,1,1,0,0,0,77,233,255,253,148,0,0,0,0,0,0,0,0,0,0,0,1,1,0,0,1,0,0,0,0,0,0,0,0,0,0,0,38,219,255,255,177,0,0,0,0,0,0,1,0,0,0,0,0,0,0,0,0,0,0,0,0,0,0,0,0,0,0,0,0,188,255,255,212,13,1,0,0,0,1,0,0,0,0,0,0,0,0,0,0,0,0,0,0,0,0,0,0,0,0,0,0,121,247,255,243,106,0,0,0,0,0,0,0,0,0,0,0,0,0,0,0,0,0,0,0,0,0,0,0,0,0,0,0,38,216,254,255,203,13,0,0,0,0,0,0,0,0,0,0,0,0,0,0,0,0,0,0,0,0,0,0,0,0,0,0,0,128,247,255,254,186,28,0,0,0,0,0,93,199,90,0,1,0,0,1,0,0,0,0,0,0,0,0,0,0,0,0,0,0,160,251,255,255,240,190,162,162,174,226,254,242,93,0,0,0,0,1,0,1,0,0,0,0,0,0,0,0,0,0,0,0,1,143,240,255,255,255,255,255,254,255,254,242,93,0,0,0,0,0,0,0,0,0,0,0,0,0,0,0,0,0,0,0,0,0,43,156,224,248,255,255,251,235,185,81,0,0,0,0,0,0,0,0,0,0,0,0,0,0,0,0,0,1,0,0,0,0,0,0,0,13,187,251,161,0,0,0,0,0,0,0,0,0,0,0,0,0,1,0,0,0,0,0,0,0,0,0,0,0,0,0,0,0,66,228,244,110,0,0,0,0,1,0,0,0,0,0,0,0,0,0,0,0,0,0,0,0,0,0,0,0,0,0,0,0,0,190,255,185,0,0,0,0,0,0,0,0,0,0,0,0,0,0,0,0,0,0,1,0,0,0,0,0,0,177,168,162,176,242,255,194,0,0,0,0,0,0,0,0,0,0,0,0,0,0,0,0,0,0,0,0,0,1,0,0,0,213,255,255,255,255,253,160,0,0,0,0,0,0,0,0,0,0,0,0,0,0,0,1,0,0,0,0,1,0,0,0,0,184,245,255,254,240,164,13,0,0,0,0,0,0,1,0,0,1,1,0,0,0,0,0,0,0,0,0,0,0,0,0,0,0,0,0,0,0,0,0,0,0,0,0,0,0,0,0,0,0,1,0,0,0,0,1,0,0,1,0,1,0,0,0,0,0,0,0,0,0,0,0,0,0,1,0,0,0,0,0,0,0,0,};
unsigned char turkish_g[]
{0,0,0,0,0,0,1,0,0,0,0,0,0,0,0,0,0,1,0,0,0,1,0,0,0,0,0,0,0,0,0,0,0,0,1,0,0,0,0,0,0,0,0,0,0,0,0,0,0,0,0,0,0,0,0,0,0,0,0,0,0,1,0,0,0,0,0,0,0,0,0,1,0,0,0,1,0,0,0,1,0,0,0,0,0,0,0,0,0,0,0,0,0,0,0,0,0,0,0,0,0,0,0,1,0,0,0,0,115,199,93,0,0,0,166,185,46,0,0,0,0,0,0,0,0,0,0,0,0,0,0,0,0,0,0,0,0,0,0,0,118,246,187,13,1,104,239,205,0,0,0,0,0,0,0,0,0,0,0,0,0,0,0,0,0,0,0,0,0,1,0,0,42,218,255,246,243,252,250,141,0,0,0,0,0,0,0,0,0,0,0,0,0,0,0,0,0,0,0,0,0,0,0,0,1,79,208,252,255,241,153,13,0,0,0,0,0,0,0,0,0,0,0,0,0,0,1,0,0,0,0,0,1,0,0,0,0,1,0,0,0,0,0,0,1,0,0,0,0,0,0,0,0,1,0,0,1,0,0,0,0,0,0,0,0,1,0,0,0,0,0,0,0,0,0,0,0,0,0,0,1,1,0,0,0,0,0,1,0,0,0,0,0,0,0,0,0,0,0,1,57,187,247,255,247,194,108,242,242,93,0,0,0,0,0,1,0,0,0,0,0,0,0,0,1,1,0,0,0,0,0,66,218,255,254,244,244,255,223,244,243,92,0,0,0,1,0,0,0,0,0,0,0,0,0,0,0,0,0,0,0,1,0,178,254,240,124,0,0,137,247,255,242,93,0,0,0,0,0,0,0,0,0,1,0,0,0,0,0,0,0,0,0,0,73,232,254,169,0,0,0,0,194,255,242,93,0,0,0,0,0,0,0,0,0,0,0,0,0,0,0,1,1,0,0,0,118,246,246,118,0,0,0,0,140,251,242,93,0,0,1,0,0,0,0,0,0,0,0,0,0,0,0,0,0,0,0,1,148,253,241,90,0,0,0,0,108,244,242,93,0,0,0,0,1,0,0,1,0,0,0,0,0,0,0,0,0,0,0,0,156,255,228,66,0,0,0,0,93,242,242,92,0,0,0,0,1,0,0,0,0,0,0,0,0,0,0,0,0,0,0,0,148,253,240,90,0,1,0,0,108,244,242,93,0,0,0,0,0,0,0,0,0,0,0,0,0,0,0,0,0,0,0,1,118,246,246,118,0,0,0,0,141,251,242,93,0,0,0,0,0,0,0,0,0,0,0,0,0,0,0,0,0,0,0,0,73,232,255,172,1,0,0,0,194,255,242,93,0,0,0,0,0,0,0,0,0,0,0,0,0,0,0,0,1,1,0,0,0,178,254,244,134,0,0,137,247,255,242,93,0,0,1,0,0,0,0,0,0,0,0,0,0,0,0,0,0,0,0,0,0,66,218,255,254,245,245,254,219,243,242,93,0,0,0,0,0,1,0,0,0,0,0,0,0,0,0,0,0,0,1,0,0,0,56,187,247,255,247,187,109,242,242,93,0,0,0,0,0,0,0,0,1,0,0,0,0,0,0,0,1,0,0,0,1,0,0,0,0,0,0,0,118,246,237,85,0,0,0,0,0,0,0,0,0,0,0,0,0,0,0,0,0,0,0,0,0,1,0,1,1,0,0,0,166,254,219,38,0,0,0,0,0,0,0,0,0,0,0,0,0,0,0,0,0,0,0,0,0,61,181,119,13,1,0,110,239,255,166,0,0,0,0,0,0,0,0,0,0,0,0,0,0,1,0,0,0,0,0,0,0,66,228,255,251,242,245,254,255,209,42,0,0,1,0,1,0,0,1,0,0,0,0,0,0,1,0,0,0,0,0,0,0,38,173,232,251,255,254,237,163,28,0,0,0,0,0,1,0,0,1,0,0,1,0,0,0,0,0,0,0,0,0,0,0,0,0,0,0,0,0,0,0,1,0,1,0,0,0,0,0,0,0,0,0,0,0,0,0,0,0,0,0,0,0,0,0,0,0,0,0,0,0,0,0,0,0,0,1,0,0,1,0,0,0,0,0,0,0,0,0,0,0,0,0,0,1,0,0,0,1,0,1,0,0,0,0,0,1,0,0,0,0,0,0,0,1,0,0,0,0,0,0,0,0,0,0,0,0,0,0,0,0,0,1,0,0,0,0,0,0,0,1,0,0,0,0,0,0,0,0,0,0,0,0,0,0,0,0,0,0,0,0,1,0,0,0,0,0,0,0,0,0,0,0,0,0,0,0,0,0,0,0,0,};
unsigned char turkishU[]
{0,0,0,0,0,0,0,0,0,0,0,0,118,162,153,56,38,144,162,118,0,0,0,0,0,0,0,0,0,0,0,0,0,0,0,0,0,0,0,0,0,0,0,0,188,255,242,93,66,228,255,188,0,1,0,0,0,0,0,0,0,0,0,0,0,0,0,0,0,0,0,0,0,0,0,0,188,255,242,93,66,228,255,188,0,0,0,0,0,0,0,0,0,0,0,0,0,0,0,1,0,0,0,0,0,0,0,0,0,0,0,0,0,0,0,0,0,0,0,0,0,0,0,1,0,0,0,0,0,0,0,0,0,0,0,0,0,0,188,255,242,93,0,1,0,0,66,228,255,188,0,0,0,1,0,0,0,0,0,0,0,0,0,0,0,0,0,0,0,0,188,255,243,93,0,0,0,0,66,229,255,188,0,0,0,0,0,0,0,0,0,0,0,0,0,0,0,0,0,0,0,0,188,255,242,92,0,0,0,0,66,228,254,188,0,0,0,0,0,0,0,0,0,0,0,0,0,0,1,0,0,0,0,0,188,255,242,93,0,0,0,0,67,228,255,188,0,0,0,0,0,0,0,0,0,0,0,0,0,0,0,0,0,0,0,0,188,255,242,93,0,0,0,0,66,228,255,188,0,0,0,0,0,0,0,0,0,0,0,0,0,0,0,0,0,0,0,0,188,255,242,93,0,0,1,0,66,228,255,188,0,0,0,0,0,0,0,0,0,0,0,0,0,0,0,0,0,0,0,0,188,255,242,93,0,0,0,0,66,228,255,188,0,0,0,0,0,0,0,0,0,0,0,0,0,0,0,0,0,0,0,0,188,255,242,93,0,0,0,0,66,228,255,188,0,0,0,0,0,0,0,0,0,0,0,0,0,0,0,0,0,0,0,0,188,255,242,93,0,0,0,0,66,229,255,188,0,0,0,1,1,0,1,0,0,0,0,0,0,0,0,0,0,0,0,0,189,255,242,93,0,0,0,0,66,228,255,188,0,0,0,0,0,0,0,0,0,0,0,0,0,0,0,0,0,0,0,0,188,255,242,93,0,0,0,0,66,228,255,188,0,0,0,0,1,0,0,0,0,0,0,0,0,1,0,0,0,0,0,0,188,255,243,93,1,1,0,0,66,228,255,188,0,0,0,0,0,0,0,0,0,0,0,0,0,0,0,0,0,0,0,0,168,255,242,93,0,0,0,0,66,229,255,188,0,0,0,0,0,0,0,0,0,1,0,0,0,0,0,0,0,0,0,0,156,255,242,93,0,1,0,0,66,229,255,176,0,0,0,0,0,0,1,0,0,0,0,0,0,0,0,0,0,0,0,0,126,248,250,137,1,0,0,0,112,245,253,149,1,0,0,0,0,0,1,0,0,0,0,0,0,0,0,0,0,0,0,0,56,222,255,233,112,0,0,99,227,255,233,81,0,0,0,0,0,0,0,0,0,0,0,0,0,0,0,0,0,0,0,0,0,118,241,255,255,251,251,255,255,246,131,0,0,0,0,0,0,0,0,0,0,0,0,0,0,0,0,0,0,0,0,0,0,0,71,187,241,254,255,245,203,93,0,0,0,0,0,0,0,0,1,1,0,0,0,0,0,0,0,0,0,0,0,0,1,1,0,0,0,0,1,0,0,0,0,0,1,0,0,0,0,0,0,0,0,0,0,0,1,0,0,1,0,0,0,0,0,0,0,1,0,0,0,0,0,0,0,0,0,0,0,0,0,0,0,0,0,0,0,0,0,0,0,0,0,0,0,1,0,0,0,0,0,0,0,0,0,0,0,0,1,0,0,0,0,0,0,0,0,0,0,0,0,0,0,0,0,0,0,0,0,0,0,0,0,0,0,0,0,0,0,0,0,1,0,0,0,0,0,0,0,0,0,0,0,0,0,0,0,0,1,0,0,0,0,0,0,0,0,0,0,0,0,0,0,0,0,0,0,0,0,0,0,0,0,0,0,0,0,0,0,0,0,0,0,0,0,0,0,0,0,0,0,0,0,0,0,0,0,0,0,0,1,0,0,0,0,0,0,0,0,1,0,1,0,0,0,1,0,1,0,0,0,0,0,0,0,0,0,0,0,0,0,0,0,0,0,0,0,0,0,0,0,0,0,0,0,0,1,0,0,0,0,1,0,0,1,0,1,0,0,0,0,0,0,0,0,0,0,0,0,0,0,0,0,1,0,0,0,0,0,0,0,0,0,0,0,0,0,0,0,0,0,0,0,0,0,0,0,0,0,0,0,0,0,0,0,0,0,0,0,0,0,0,0,0,0,0,0,0,0,0,0,0,0,0,0,0,0,1,0,0,0,0,};
unsigned char turkish_i[]
{1,0,0,0,0,1,0,1,0,0,0,0,0,0,1,0,0,0,0,0,0,0,0,0,0,0,1,0,1,1,0,0,0,0,0,0,1,0,0,0,0,1,0,0,0,0,0,0,0,0,0,0,0,0,0,0,0,0,0,0,0,1,0,0,0,0,0,0,0,0,0,1,0,0,0,1,0,0,0,0,0,0,0,1,0,0,0,0,0,0,0,0,0,0,1,1,0,0,0,0,0,0,0,0,0,0,0,1,0,1,0,0,0,0,1,0,0,0,1,0,0,0,0,0,0,0,0,0,0,1,0,0,0,0,0,0,0,0,0,1,0,0,0,0,0,0,0,1,0,0,0,0,0,0,0,0,0,0,0,0,0,0,0,0,0,0,1,0,0,0,0,0,0,0,0,0,0,0,0,0,0,0,0,0,0,0,0,0,1,0,0,0,0,0,0,0,0,0,0,0,0,0,0,0,0,0,0,0,0,0,0,0,0,0,0,0,0,0,1,0,0,0,0,0,0,0,0,0,1,0,0,0,0,0,156,255,254,255,255,255,255,228,66,0,0,0,0,0,1,0,1,0,0,0,1,0,1,0,0,0,0,0,1,0,0,0,156,255,255,255,255,254,255,228,66,0,0,0,0,0,0,0,0,0,0,0,0,0,1,0,0,0,0,0,0,0,1,0,96,162,162,162,175,247,255,228,66,0,1,0,0,0,1,0,0,0,0,0,0,1,0,0,0,0,0,0,0,0,0,0,0,0,0,0,93,243,255,228,66,1,0,0,0,0,1,0,0,0,0,0,0,0,0,0,1,0,0,0,1,0,0,0,0,0,0,0,93,242,255,228,66,0,0,0,0,0,0,0,0,0,0,0,0,0,0,0,0,0,0,0,0,1,0,0,0,0,0,0,93,242,254,228,66,0,0,0,0,0,0,0,0,0,0,0,0,0,0,0,1,0,0,0,0,0,0,0,0,0,0,0,93,242,255,228,66,0,1,0,0,0,0,0,0,0,0,0,0,0,0,0,0,0,0,1,0,0,0,0,0,0,0,0,93,242,255,228,66,0,0,0,0,0,0,0,0,0,0,0,0,0,0,0,0,0,0,1,0,0,0,0,0,0,0,0,93,242,255,228,66,0,0,0,0,0,0,0,0,0,0,0,0,0,0,0,0,0,0,0,0,0,0,0,0,0,1,0,93,242,255,228,67,0,0,1,0,0,0,0,0,0,0,0,0,0,0,0,0,0,0,0,0,0,0,0,0,0,0,0,93,242,255,228,66,0,0,0,0,0,0,0,1,0,0,0,0,0,0,1,0,0,0,0,0,0,0,0,0,0,0,0,93,242,255,228,66,0,0,0,0,0,0,0,0,0,0,0,0,0,0,0,0,0,0,0,0,0,0,0,0,0,0,0,93,242,255,229,66,0,0,0,0,0,0,0,0,0,0,0,0,0,0,0,0,0,0,0,0,0,0,0,0,0,0,0,93,242,254,228,66,0,0,0,0,0,0,1,0,0,0,1,0,0,1,0,0,0,0,0,0,0,0,118,162,162,162,162,175,247,255,238,169,162,162,162,162,96,1,0,0,0,0,0,0,0,0,0,0,0,1,0,1,0,0,188,255,255,255,255,255,255,255,254,255,255,255,255,255,156,0,0,0,0,0,0,0,0,0,0,0,0,0,0,0,0,0,188,255,255,255,255,255,255,255,255,255,255,255,255,255,156,0,0,0,0,0,0,0,0,0,0,0,1,0,0,0,0,0,0,0,0,0,0,0,1,0,1,0,1,0,0,0,1,0,0,0,1,0,0,0,0,0,0,0,0,0,0,0,1,0,0,0,0,0,0,0,0,0,0,1,0,0,0,0,0,0,0,0,0,0,0,0,0,0,0,0,0,0,0,0,0,1,0,0,0,0,0,0,0,0,0,0,0,0,0,0,0,0,0,0,0,0,0,0,0,0,0,0,0,0,0,0,0,0,0,0,0,0,0,0,0,0,0,0,1,0,0,0,0,0,0,0,0,0,0,0,0,1,0,0,0,0,0,0,0,0,0,0,0,0,0,0,0,1,0,0,0,0,0,0,0,0,1,0,0,0,0,0,0,0,0,0,1,0,0,1,0,0,0,0,0,0,0,0,0,1,0,0,0,0,0,0,0,0,0,0,0,0,0,0,0,0,0,0,0,0,0,0,1,0,0,0,0,0,0,0,0,0,0,0,1,1,0,0,0,0,0,0,0,0,0,0,0,1,0,0,0,0,0,0,0,0,1,0,0,0,0,0,0,0,0,0,0,0,0,0,0,0,0,1,0,0,1,0,0,};
unsigned char turkish_u[]
{0,0,0,0,0,0,1,0,0,0,0,0,0,0,0,0,0,0,0,0,0,0,0,0,0,0,0,0,0,0,0,0,0,0,0,1,0,0,0,0,0,0,0,156,255,255,213,0,0,156,255,255,212,0,0,0,0,0,0,0,0,0,0,0,0,0,0,0,0,0,0,0,0,0,0,156,254,255,213,0,0,156,255,255,213,0,0,1,0,0,0,0,0,0,0,0,0,0,0,0,0,0,0,0,0,0,1,156,255,255,213,1,0,156,255,255,213,0,0,0,0,0,0,0,0,0,0,0,0,0,0,0,0,0,0,0,0,1,0,0,0,1,0,0,0,0,0,0,0,0,0,0,0,0,0,0,0,1,0,0,0,0,1,0,0,0,0,0,0,0,0,0,0,0,0,0,0,0,0,0,0,0,0,0,0,0,0,0,0,0,0,0,0,1,0,0,0,0,0,0,0,0,0,0,0,0,0,0,0,0,0,0,1,1,0,0,0,0,0,0,1,0,0,0,0,0,0,0,0,0,0,1,0,131,249,255,188,0,0,0,0,0,0,93,242,255,212,0,0,0,0,0,0,0,0,0,0,0,0,0,0,0,0,0,0,130,248,255,188,0,0,0,0,0,0,93,242,255,213,0,0,0,0,0,1,0,0,0,0,0,0,1,0,0,0,0,0,130,249,255,188,0,0,0,0,0,0,93,242,255,213,0,0,0,0,0,0,0,1,0,0,0,0,0,0,0,0,0,0,131,249,255,188,0,0,1,0,0,0,93,242,255,213,0,0,0,0,0,0,0,0,0,0,0,0,0,0,0,0,0,0,130,249,255,189,0,0,0,0,0,0,93,242,255,213,0,0,0,0,0,0,0,0,0,0,0,0,0,0,0,0,0,0,130,248,255,188,0,1,0,0,0,0,93,242,255,212,0,0,0,0,0,0,0,0,0,0,0,0,0,0,0,1,0,0,130,249,254,188,0,1,0,0,0,0,93,242,255,213,0,0,0,0,0,0,0,0,0,0,1,0,0,0,0,0,0,0,131,249,255,188,0,0,0,0,0,0,92,242,255,213,1,0,0,0,0,0,0,0,0,0,0,0,0,1,0,0,0,1,130,249,255,188,0,0,0,0,0,0,93,242,255,213,0,0,0,0,0,0,0,0,0,0,0,0,0,0,0,0,0,0,130,249,255,188,0,0,0,0,0,0,93,242,255,213,0,0,0,1,0,0,0,0,0,0,0,0,0,0,0,0,1,0,130,249,255,191,0,0,0,0,0,0,126,248,255,213,0,0,0,0,0,0,0,0,0,0,0,0,0,0,0,0,0,0,130,249,255,213,0,0,0,0,1,0,149,253,255,213,0,0,0,0,0,0,0,0,0,0,0,0,0,0,0,0,0,0,98,243,255,228,66,0,0,0,0,13,206,255,255,212,0,0,0,0,0,0,0,0,0,0,0,0,0,0,0,0,0,1,66,228,255,253,164,0,0,0,0,161,252,255,255,213,0,0,0,0,0,0,0,0,0,0,0,0,0,0,0,0,0,0,0,178,254,255,255,214,164,168,218,254,227,245,255,213,0,0,0,0,0,0,0,0,1,0,0,0,1,0,1,0,0,0,0,73,224,255,255,255,255,255,255,229,129,242,255,213,1,0,0,0,0,0,1,0,0,0,0,0,1,0,0,0,0,0,0,0,56,181,243,255,255,241,181,57,93,242,255,213,0,0,0,0,0,0,0,0,1,0,0,0,0,0,0,0,0,0,1,0,0,0,0,0,0,0,0,0,0,0,1,1,0,0,0,0,0,0,0,0,0,0,0,0,0,0,0,0,0,0,0,0,0,0,0,0,0,0,0,0,0,0,0,0,0,0,1,0,0,1,0,0,0,0,0,0,0,0,0,0,0,0,0,0,0,0,0,0,0,0,0,0,0,0,0,0,0,0,0,0,0,0,0,0,0,0,0,0,1,0,1,0,0,0,0,0,0,0,0,0,0,0,0,0,0,0,0,0,0,0,1,0,0,0,0,0,0,0,0,0,0,0,0,0,0,0,0,0,0,0,1,0,0,0,0,0,0,0,0,0,0,0,0,0,0,0,0,1,0,0,0,0,0,0,0,0,0,0,0,0,0,0,0,0,0,0,0,0,0,0,0,0,0,0,0,0,0,0,1,0,0,0,0,0,0,0,0,0,1,0,0,0,0,0,0,0,0,1,0,0,0,0,0,0,0,0,0,0,0,0,0,0,0,0,0,0,0,0,0,0,0,0,0,0,0,0,0,0,0,0,0,0,0,0,0,0,0,0,0,0,0,0,1,0,0,};
unsigned char twopoint[]
{0,1,0,0,1,0,0,0,0,0,0,0,0,0,0,0,0,0,0,0,0,0,0,0,0,1,0,0,0,0,0,1,0,1,0,0,0,1,0,0,0,1,0,0,0,0,0,0,0,0,1,0,0,0,0,0,0,0,0,0,0,0,0,0,0,0,0,0,0,0,0,0,0,1,0,0,0,0,0,0,0,0,0,0,0,0,0,0,0,0,0,0,0,0,0,0,0,0,0,0,0,0,0,0,0,0,0,1,0,0,0,0,0,0,0,0,0,0,1,0,0,0,0,0,0,0,0,0,0,0,0,0,0,0,0,0,0,0,0,0,0,0,0,0,1,0,0,0,0,0,0,0,0,0,0,0,0,0,0,0,0,0,0,0,0,0,0,0,0,0,0,0,0,0,0,0,0,0,0,0,0,0,0,0,0,0,0,0,0,0,0,0,0,0,0,0,0,0,0,0,0,0,0,1,0,0,0,0,0,0,0,0,0,0,0,0,0,0,1,0,0,0,0,0,0,0,0,0,0,0,0,0,0,0,0,0,0,0,0,0,0,0,0,0,0,0,0,0,1,0,0,0,0,0,0,0,0,0,0,0,0,0,0,0,0,0,0,0,0,67,229,255,255,242,93,0,0,0,0,0,0,1,1,0,0,0,0,0,0,0,0,0,0,0,1,0,0,0,0,0,0,67,228,255,255,242,92,0,0,0,0,0,0,0,0,0,0,0,0,0,0,0,0,0,0,0,0,0,0,0,0,0,0,66,228,255,255,242,93,0,1,0,0,0,0,0,0,0,0,0,0,0,0,0,0,1,0,1,0,0,0,0,0,0,0,66,228,255,255,242,93,0,0,0,0,0,0,1,0,0,0,0,0,0,0,0,0,0,0,0,0,0,0,1,0,0,0,67,228,255,255,242,93,0,0,0,0,0,0,0,1,0,0,0,0,0,0,0,0,1,0,0,1,0,0,0,0,0,0,1,0,0,0,0,0,0,0,0,0,0,1,0,0,0,0,0,0,0,0,0,0,0,0,1,0,0,0,0,0,0,0,0,0,0,0,0,0,0,0,0,0,0,0,0,0,0,0,0,1,0,0,0,0,0,1,0,0,1,0,0,0,0,0,0,0,0,0,1,0,0,1,0,0,0,0,0,0,0,0,0,0,0,0,0,0,0,0,0,0,0,0,0,0,0,1,0,0,0,1,0,0,0,0,0,0,0,0,0,1,0,0,1,0,0,0,0,0,0,0,0,1,1,0,0,0,0,0,0,0,0,0,0,0,0,0,0,1,0,0,0,0,0,0,0,0,0,0,0,1,0,0,0,0,0,0,0,0,0,0,0,0,0,0,0,0,0,0,1,0,0,0,0,0,0,0,0,0,0,0,0,0,0,0,0,0,0,1,0,0,0,0,66,228,255,255,242,93,0,0,0,0,0,0,0,0,0,0,0,0,0,0,0,0,0,0,0,0,0,0,0,0,0,0,66,228,254,255,242,93,0,0,0,0,0,1,1,0,0,0,1,0,0,0,0,0,0,1,0,0,1,0,0,1,1,0,66,228,254,255,242,93,0,0,0,0,0,0,0,0,0,0,0,0,0,0,0,1,0,0,0,0,0,0,0,1,0,0,66,228,255,255,242,93,0,0,0,0,0,0,0,0,0,1,0,0,0,0,0,0,0,0,0,0,0,0,0,0,0,0,66,228,255,254,242,92,0,0,0,1,0,0,0,1,0,0,0,0,0,0,0,0,0,0,0,1,0,0,0,0,0,0,0,0,0,0,0,0,0,0,0,0,0,0,0,0,0,0,0,1,0,0,0,0,0,0,0,0,0,0,0,0,0,1,0,0,0,0,0,0,1,0,0,0,0,0,0,0,0,0,0,1,0,0,0,0,1,0,0,0,0,0,1,0,0,0,0,0,0,0,0,0,0,0,0,0,0,0,0,0,0,0,0,0,0,0,1,0,0,0,1,0,0,0,1,0,0,0,0,0,0,0,0,0,0,0,0,0,0,0,0,0,0,0,0,0,0,1,0,0,0,0,0,0,1,0,0,0,0,0,1,1,1,0,0,0,0,0,0,0,0,0,0,0,0,0,1,0,0,0,0,0,0,0,0,0,0,0,1,0,0,0,0,0,0,0,1,0,0,0,0,0,0,0,0,0,1,1,0,0,0,0,0,0,0,0,0,0,0,0,0,0,0,0,0,0,0,0,0,0,1,1,0,0,1,0,0,0,0,0,0,0,0,1,0,0,1,0,0,0,0,0,0,0,0,0,0,0,0,0,0,0,0,0,1,0,0,0,0,0,0,0,0,1,0,};
unsigned char turkishG[]
{0,0,0,0,0,0,0,0,0,0,0,0,0,210,230,79,0,1,146,248,148,0,0,0,0,0,0,0,0,0,0,0,0,0,1,0,0,0,0,0,0,0,1,0,0,148,252,252,243,245,254,237,88,0,0,0,0,0,0,0,0,0,0,0,0,0,0,0,0,0,0,0,1,0,0,0,0,13,164,243,255,252,221,105,0,0,0,0,1,0,0,0,0,1,0,0,0,0,0,0,0,0,0,1,0,0,0,0,0,0,0,0,0,0,0,0,0,0,0,0,0,0,0,0,0,0,1,0,0,0,0,0,0,0,0,0,0,0,0,1,0,0,0,0,0,0,0,0,0,0,0,0,0,0,1,0,0,1,0,0,0,0,0,0,0,0,0,0,0,0,0,0,0,56,179,237,254,255,248,212,114,0,0,0,0,0,1,0,0,0,0,0,0,0,0,0,0,0,0,0,0,0,0,0,110,236,254,254,245,243,248,255,248,126,0,0,1,0,0,1,0,0,0,0,0,0,0,0,0,0,0,0,0,0,0,88,237,255,227,99,0,0,13,124,228,130,0,0,0,0,0,0,0,0,0,0,0,0,0,0,0,0,1,0,0,0,1,194,255,237,88,0,0,0,0,0,50,59,0,0,0,0,0,0,0,0,0,0,0,0,0,0,1,0,0,1,0,0,85,237,255,180,0,0,0,0,0,0,0,0,1,0,1,0,0,0,0,0,1,0,0,0,0,0,0,0,0,0,0,0,140,251,248,127,0,0,0,0,0,0,0,0,0,0,0,0,0,0,0,0,0,0,0,0,0,0,0,0,0,0,0,0,168,255,242,93,0,0,0,0,0,0,0,0,0,0,0,0,0,0,0,0,0,0,0,0,0,0,0,0,0,0,0,0,189,255,228,66,0,1,0,0,0,1,0,0,0,0,0,0,0,0,0,0,0,0,0,0,0,0,0,0,0,0,0,0,188,255,228,67,0,0,66,228,255,255,255,213,0,0,0,0,0,0,0,0,0,0,0,0,0,0,0,0,0,0,1,0,188,255,228,66,0,0,61,216,242,248,255,213,0,0,0,0,0,0,0,0,0,0,0,0,0,0,0,0,0,0,0,0,168,255,240,90,0,0,0,0,0,188,255,213,0,0,0,0,0,0,0,0,0,0,0,0,0,0,1,0,0,0,0,0,140,251,247,118,0,0,0,0,0,188,255,212,1,1,0,1,0,0,0,0,0,0,0,0,0,0,0,0,0,0,0,0,84,236,255,168,0,0,0,0,0,188,255,213,0,0,0,1,1,0,0,1,0,1,0,0,0,0,0,0,0,0,0,1,0,194,255,233,81,0,0,0,0,189,255,213,0,0,0,0,0,0,0,0,0,0,0,0,0,0,0,0,0,0,0,0,0,98,238,255,219,88,0,0,28,201,254,213,0,0,0,0,0,0,1,0,0,0,0,0,0,0,0,1,0,0,0,0,0,0,118,238,255,255,244,242,251,255,254,191,0,0,0,0,0,0,0,1,0,1,0,0,0,0,0,0,0,0,0,0,0,0,0,64,182,240,254,255,248,216,118,0,0,0,0,0,0,0,0,0,0,0,0,0,0,1,0,1,0,1,0,0,0,0,0,0,1,0,0,0,0,0,0,0,0,0,0,1,0,0,0,0,0,0,0,0,0,0,0,0,0,0,0,1,0,0,0,0,0,0,0,0,0,1,0,0,0,0,0,0,0,0,0,0,0,0,0,0,0,0,0,0,0,0,0,0,0,0,0,0,0,0,0,0,0,0,0,0,0,0,1,0,0,0,0,0,0,1,1,0,0,0,0,0,0,0,0,0,0,0,0,0,0,0,0,0,0,0,0,0,1,0,0,0,0,0,0,0,1,0,0,0,0,0,0,0,0,0,0,0,0,0,0,0,0,0,0,0,0,0,0,0,0,0,0,0,1,1,0,0,0,0,0,0,0,0,0,0,0,0,1,0,0,0,0,0,0,0,0,0,0,0,1,0,0,0,0,0,0,0,0,0,0,0,0,0,0,0,0,0,0,0,0,0,0,0,0,0,0,0,0,0,0,0,1,0,0,0,0,0,0,0,0,0,0,0,0,0,0,0,1,0,0,0,0,0,0,0,0,0,0,0,0,0,0,0,0,0,0,1,0,0,0,0,0,0,0,0,0,0,0,1,0,0,0,1,0,0,1,1,0,1,0,0,0,0,0,0,0,0,0,0,0,0,0,0,0,0,0,0,0,0,0,0,0,0,0,0,0,0,0,0,0,0,0,0,1,0,0,0,0,0,0,0,0,0,0,0,0,0,0,0,};
unsigned char turkishO[]
{0,0,0,0,0,0,0,0,1,0,0,0,118,162,153,56,39,144,162,118,1,0,0,0,0,1,0,0,0,0,0,1,0,1,0,0,0,0,0,0,0,0,1,1,188,255,242,93,66,228,254,188,0,0,0,0,0,0,0,0,0,0,0,0,0,0,0,0,0,1,0,0,0,0,0,0,188,255,242,93,67,228,255,188,0,0,0,0,0,0,0,0,0,0,0,0,0,0,0,0,1,0,1,0,0,0,0,0,0,0,0,0,0,1,0,0,0,0,0,0,0,0,1,0,0,1,1,1,1,1,0,0,0,0,0,0,0,0,1,0,56,170,238,255,254,240,181,56,0,0,0,0,0,0,0,0,0,0,0,0,0,0,0,0,0,0,0,0,0,0,0,73,218,254,255,251,250,255,255,227,73,0,0,0,0,0,0,0,0,0,0,0,0,1,0,0,0,1,0,0,0,0,0,188,255,246,150,12,13,135,242,255,203,13,0,0,0,0,0,1,0,0,0,0,0,0,0,0,0,0,0,0,1,0,90,238,255,188,0,0,0,0,169,254,247,118,0,0,0,0,0,0,0,0,0,0,1,0,1,1,0,0,0,0,0,0,148,253,246,118,0,0,1,0,96,241,255,177,0,0,0,0,0,0,0,0,0,0,0,0,1,0,0,0,0,0,0,0,190,255,233,77,0,0,0,0,61,227,255,210,1,0,0,0,0,1,1,0,0,0,0,0,0,0,0,0,0,1,0,0,213,255,227,61,0,0,0,0,0,213,255,227,61,0,0,0,0,0,0,0,0,0,0,0,0,0,0,0,0,0,0,38,218,255,213,0,0,0,0,0,1,205,255,228,66,0,0,0,0,0,0,0,0,0,1,0,1,0,0,1,0,0,0,66,228,255,213,0,0,0,0,0,0,188,255,228,66,0,0,0,0,0,0,0,0,0,1,0,0,0,0,0,0,0,0,66,229,255,213,0,0,0,0,0,0,188,255,228,66,1,1,0,0,0,0,0,0,0,0,0,0,0,0,0,0,0,0,38,219,255,213,0,1,0,0,0,0,205,255,228,67,0,0,0,0,0,0,0,0,0,0,0,0,0,0,0,0,0,0,0,213,255,227,61,0,0,0,0,0,213,255,227,60,0,0,0,0,0,1,0,0,0,0,0,0,0,0,0,0,1,0,0,190,255,233,77,0,0,0,0,61,227,255,210,0,0,0,1,0,0,0,0,0,0,0,0,0,0,0,0,0,0,0,0,153,254,247,118,0,0,0,0,96,241,255,177,0,0,0,0,0,0,0,0,0,0,0,0,0,0,0,0,0,0,0,1,90,238,255,188,0,0,0,0,169,254,246,118,0,0,0,0,0,0,0,0,0,0,1,0,0,0,0,0,0,0,1,0,0,188,254,247,150,13,13,135,242,255,203,13,0,0,1,0,0,0,0,0,0,0,0,0,0,0,0,0,0,1,0,0,0,73,224,255,255,251,250,255,255,227,73,0,0,0,0,0,0,0,0,0,1,0,1,0,0,0,0,0,0,0,1,0,0,0,56,181,241,254,254,241,181,56,0,1,0,0,0,1,0,0,0,0,0,0,1,0,0,0,0,0,0,0,0,0,0,0,0,0,0,0,0,0,0,0,0,1,0,0,0,0,0,1,0,0,0,0,0,0,0,0,1,0,0,0,0,0,0,0,0,0,0,0,0,0,0,0,0,0,0,0,0,0,0,0,0,0,0,0,0,0,0,0,1,0,0,1,0,0,1,0,0,0,0,0,0,0,0,0,0,0,0,0,0,0,0,0,0,0,0,0,1,0,0,1,0,0,0,0,0,0,0,0,0,0,0,0,0,0,0,0,0,0,1,0,0,0,0,0,0,0,0,1,0,0,0,0,0,0,0,0,0,0,0,0,0,0,0,0,0,0,0,0,1,0,0,0,0,0,0,1,0,0,0,0,0,0,0,0,1,0,0,0,1,0,0,0,0,1,0,0,0,0,0,0,0,0,1,0,0,0,0,0,1,0,0,1,0,0,1,0,0,0,0,0,1,0,0,0,0,0,0,0,0,0,0,0,0,0,1,0,0,0,0,0,0,0,0,0,1,0,0,0,0,0,0,0,0,0,0,0,0,0,0,0,1,0,0,0,0,0,0,0,1,0,0,0,0,0,0,0,0,0,0,1,0,0,0,0,0,0,0,0,0,0,0,0,0,0,0,0,0,0,0,0,0,0,0,0,0,0,0,0,0,0,0,0,0,0,0,0,0,0,0,0,0,0,0,0,0,0,0,0,0,0,0,0,1,0,0,0,0,0,0,0,};
unsigned char turkishS[]
{0,0,0,0,0,0,0,0,0,0,0,0,0,0,0,0,0,0,0,0,0,0,0,0,0,0,0,0,0,0,1,0,0,0,1,0,0,0,0,0,0,0,0,0,0,0,0,0,0,0,0,0,0,0,0,0,0,0,0,1,0,0,0,0,0,0,0,0,0,0,0,0,0,0,1,13,119,208,243,254,255,254,245,219,163,73,0,0,0,0,0,0,1,0,0,0,0,0,0,0,0,0,0,1,0,0,73,216,254,255,255,255,255,255,255,255,255,249,130,0,0,0,0,0,0,0,0,0,0,1,0,0,1,0,0,0,0,73,227,255,255,248,208,165,162,162,197,240,255,249,130,0,0,0,0,0,0,0,0,0,0,0,0,0,0,0,0,0,0,178,254,255,227,79,0,0,0,0,0,13,119,214,128,1,0,0,0,0,0,0,0,0,0,0,0,0,0,0,0,0,66,228,255,247,121,0,1,0,0,0,0,0,0,13,28,0,0,1,0,0,0,0,0,0,0,0,0,0,0,0,0,0,93,242,255,230,69,0,0,1,0,0,0,0,0,0,0,0,0,0,0,0,0,0,0,0,0,0,0,0,0,0,0,0,93,242,254,237,85,0,0,0,0,0,0,0,0,0,0,0,0,0,1,0,0,0,0,0,0,0,0,1,0,0,0,0,85,237,255,253,164,0,0,0,0,0,0,0,1,0,0,0,0,1,0,0,0,0,0,0,0,0,0,0,0,1,0,0,13,206,255,255,251,192,90,0,0,0,0,1,0,0,0,0,0,0,0,0,0,0,0,0,0,0,0,0,0,0,0,0,0,104,239,255,255,255,255,246,219,168,90,0,0,0,0,1,0,0,0,0,0,0,0,0,0,0,0,0,0,0,0,0,0,0,92,220,254,255,255,255,255,255,255,240,163,28,0,0,0,0,0,0,0,0,0,0,0,0,0,1,0,1,0,1,0,0,0,0,101,197,241,254,255,255,254,255,255,218,73,0,0,0,0,0,0,0,0,0,0,0,0,0,0,0,0,0,1,0,0,0,0,0,0,42,120,190,240,254,255,255,203,13,0,0,0,0,0,0,0,1,0,0,0,0,0,1,0,0,0,0,0,0,1,0,0,0,0,1,28,182,252,255,246,119,0,0,0,1,0,1,0,0,0,0,0,0,0,0,0,0,0,0,0,0,0,0,0,0,0,0,0,42,221,255,255,156,0,0,1,0,0,0,0,0,0,0,0,0,1,0,0,0,0,0,0,0,0,0,0,0,0,0,0,1,188,255,255,188,0,0,0,0,0,0,0,0,0,0,1,0,0,0,0,0,0,0,0,0,0,0,0,0,0,0,0,0,189,255,255,177,0,1,0,0,1,0,0,0,0,1,0,0,0,0,0,0,13,46,0,0,0,0,0,0,0,0,0,56,224,255,253,148,0,0,0,0,0,0,0,0,0,0,0,0,0,0,0,0,66,227,209,101,0,0,0,0,0,0,28,189,254,255,237,89,0,1,0,0,0,0,1,0,0,0,0,0,0,0,0,0,67,228,255,254,238,197,162,162,162,190,240,255,255,252,161,0,0,0,0,0,0,0,0,0,0,0,0,0,0,0,1,0,61,221,255,255,254,255,255,255,255,255,255,255,247,164,13,0,0,0,0,0,0,0,0,1,0,0,0,0,0,0,0,0,0,13,104,177,227,245,254,255,255,248,232,168,64,0,0,0,0,0,0,0,0,0,0,0,0,0,0,0,1,0,0,0,0,0,0,0,0,0,0,104,239,227,73,0,0,0,0,1,0,0,0,0,0,0,1,0,0,0,0,0,0,0,0,0,0,1,0,0,0,0,1,0,160,253,196,13,0,0,0,0,0,1,0,0,0,1,0,0,0,0,0,0,0,0,0,0,0,0,0,0,0,0,0,1,98,243,240,90,0,0,0,0,0,0,0,0,1,0,0,0,0,0,0,0,0,0,0,1,0,0,0,0,114,184,162,162,212,254,244,104,0,0,0,0,0,0,0,0,0,0,0,0,0,0,0,0,0,0,0,0,0,0,0,1,130,249,255,255,255,255,228,66,0,1,0,0,0,0,0,0,0,0,1,0,0,0,0,0,0,0,0,0,0,0,0,0,105,228,253,255,251,216,92,0,0,0,0,0,0,0,0,0,0,0,0,0,0,0,0,0,0,0,0,0,0,0,0,0,0,0,0,0,0,0,0,0,0,0,0,0,0,0,0,0,0,0,0,0,0,0,0,0,0,0,0,0,0,0,0,0,0,0,0,0,0,0,0,0,0,1,0,0,0,0,0,0,0,0,0,0,};
unsigned char turkish_s[]
{0,0,0,1,0,0,0,0,0,0,0,0,0,0,1,1,0,0,0,0,0,0,0,0,0,1,0,0,0,0,0,0,0,0,0,1,0,0,0,0,0,0,0,0,0,0,1,0,0,0,0,1,0,0,0,0,0,0,0,0,0,0,0,0,0,0,0,0,1,0,0,0,1,1,0,0,0,0,0,0,0,0,0,0,0,0,0,0,0,0,0,0,1,0,0,0,0,0,1,0,0,0,1,0,0,0,0,0,0,0,0,0,0,1,0,0,0,0,0,0,0,0,0,1,0,0,0,0,0,0,0,0,0,0,0,1,0,0,0,0,0,0,0,0,0,0,0,0,0,0,1,0,0,0,0,0,0,0,0,1,0,0,0,0,0,0,0,0,0,0,1,0,0,0,0,0,0,0,0,0,0,1,0,0,0,0,0,0,0,0,0,0,0,0,0,0,1,0,0,0,0,0,0,0,0,0,0,0,0,0,0,0,0,0,0,0,0,1,0,0,0,0,0,0,1,0,1,0,0,0,0,0,0,0,0,0,115,208,243,254,254,254,245,219,158,53,0,0,0,0,0,0,0,0,0,0,0,0,0,0,0,0,0,0,0,0,13,185,254,255,255,255,254,255,255,255,255,188,0,0,0,0,1,0,0,0,0,0,0,0,0,0,0,1,0,0,0,0,157,252,255,252,213,165,162,162,187,235,254,188,0,0,0,0,0,0,0,0,0,0,0,1,0,0,0,0,0,0,0,38,219,255,250,146,1,0,0,0,0,1,106,145,0,0,0,0,0,0,0,0,0,0,0,0,0,0,0,0,0,0,0,66,228,255,242,93,0,1,0,0,0,0,0,0,0,0,1,0,0,0,0,0,0,0,0,0,0,0,0,0,0,0,0,66,228,255,245,112,0,0,0,0,0,1,0,0,0,0,0,0,0,0,0,0,0,0,0,1,0,0,0,0,0,0,0,0,202,255,255,235,139,42,0,0,0,0,0,0,0,0,0,1,0,0,0,1,0,0,0,0,0,0,1,0,0,0,0,0,104,237,255,255,255,254,240,211,169,90,0,0,0,0,0,0,0,0,0,0,0,0,0,0,0,0,0,0,0,0,0,0,0,71,199,247,255,255,255,255,255,254,218,79,0,0,0,0,0,0,0,0,1,0,0,0,0,1,1,0,0,0,0,0,0,0,0,13,88,153,204,243,255,255,255,222,56,0,0,0,0,0,0,0,0,0,0,0,0,0,0,0,0,0,0,0,0,0,0,0,0,0,0,13,150,247,254,250,136,0,0,0,0,0,0,0,0,0,0,0,0,0,1,0,0,0,1,0,0,0,1,0,0,0,0,0,0,180,255,255,168,0,0,0,0,0,0,0,0,0,0,0,1,1,0,0,0,0,0,0,0,0,0,0,0,0,0,0,0,177,255,255,160,0,0,0,0,0,0,0,0,0,1,0,1,0,1,0,0,0,0,88,190,101,0,0,0,0,0,0,79,230,255,250,136,0,0,0,0,0,0,0,0,0,0,0,0,0,0,0,0,1,0,93,242,255,243,204,165,162,162,199,247,255,255,218,42,0,0,0,0,0,0,0,0,1,0,0,0,0,0,0,0,0,0,93,242,255,255,255,255,255,255,254,255,255,219,79,0,0,0,0,0,0,0,1,0,0,0,0,0,0,1,0,0,0,0,0,73,156,213,242,254,255,255,246,216,138,29,0,0,0,0,0,0,0,1,0,0,0,0,0,0,0,1,1,0,0,0,0,0,0,0,0,0,104,239,227,73,0,0,0,0,0,0,0,0,0,0,0,1,0,0,0,0,0,0,0,0,0,0,0,0,0,0,0,1,0,160,252,196,13,0,0,0,0,0,0,0,0,0,0,0,0,1,0,1,0,0,0,0,0,0,0,0,0,0,0,0,0,98,243,241,90,0,0,0,0,0,0,0,1,0,0,0,0,1,1,0,0,0,0,0,0,0,0,0,0,114,184,162,162,212,254,245,104,0,0,0,0,0,0,1,0,0,0,1,0,1,0,1,0,0,0,0,0,0,0,0,0,130,249,255,255,255,255,228,66,0,0,0,0,0,0,0,0,0,0,0,0,1,0,0,0,0,0,0,0,0,0,0,0,105,228,252,255,251,216,92,0,0,0,0,0,1,0,0,0,0,0,0,0,0,0,0,0,0,0,0,0,0,0,0,0,0,0,0,0,0,0,0,0,0,0,0,0,0,0,0,0,0,0,0,0,0,1,0,0,0,0,0,0,1,0,0,0,0,0,0,0,0,0,0,0,0,0,0,0,0,0,1,0,0,1,0,0,};
unsigned char turkish_o[]
{0,0,0,0,0,0,0,0,0,0,0,0,1,0,0,0,0,0,0,0,0,0,0,1,0,0,0,0,0,0,0,0,0,1,0,0,0,0,0,0,0,0,0,156,255,255,213,0,0,157,255,255,213,0,1,0,0,0,0,0,0,0,0,1,0,0,1,0,0,0,0,0,0,0,0,156,255,255,213,0,0,156,255,254,213,0,0,0,0,0,0,0,0,0,0,0,0,0,1,0,0,0,0,0,0,0,0,156,255,255,213,0,0,156,255,255,213,0,0,0,0,0,0,0,0,0,0,0,0,0,0,0,0,0,0,0,0,0,0,0,0,0,0,0,1,0,0,0,0,0,0,0,0,0,0,0,0,0,0,0,0,0,0,0,1,0,0,1,0,0,0,1,0,0,0,0,0,0,0,1,0,0,0,0,0,1,0,0,0,0,0,0,0,0,0,0,0,0,0,0,0,0,0,0,0,0,0,0,0,1,0,0,0,0,0,0,0,0,0,0,0,0,0,0,0,0,0,0,0,0,0,0,0,0,0,0,115,208,245,255,255,251,224,155,28,0,0,0,0,0,0,1,0,1,0,0,0,0,0,0,0,0,0,0,0,0,42,192,254,255,255,255,255,255,255,255,226,92,0,1,0,0,0,0,0,0,0,0,0,0,0,0,0,0,0,0,0,12,187,254,255,254,214,165,162,192,247,255,255,227,72,0,0,0,0,0,0,0,1,0,0,0,0,0,0,0,0,0,0,120,246,255,249,149,0,0,0,0,98,235,255,254,178,0,0,0,0,0,1,0,0,0,0,0,0,0,0,0,0,0,1,188,255,255,203,13,0,0,1,0,1,148,252,255,228,67,0,0,0,0,0,0,0,0,0,0,0,0,0,0,0,0,53,223,255,251,140,0,0,0,0,0,0,77,233,255,246,118,0,0,0,1,0,0,0,0,0,0,0,0,0,0,0,0,90,240,254,242,93,0,0,0,0,0,0,0,213,255,254,153,0,0,0,0,0,0,0,0,1,0,0,0,0,0,0,0,93,242,255,230,69,0,0,1,0,0,0,0,191,255,255,160,0,0,0,0,0,0,0,0,0,0,0,0,0,1,0,0,130,249,255,228,66,0,0,0,0,0,0,0,188,255,255,188,0,0,1,0,0,0,0,0,0,0,1,0,0,0,0,0,93,242,255,230,69,0,1,1,0,0,0,0,190,255,255,160,0,0,0,0,0,0,0,0,0,0,0,0,1,0,0,1,90,240,255,242,93,0,0,0,0,0,0,0,213,255,254,153,0,0,0,0,1,0,0,0,0,0,0,0,0,0,0,0,53,223,255,251,140,0,0,0,0,1,1,77,233,255,246,118,1,0,0,0,1,0,0,0,0,0,0,0,0,0,0,0,0,188,255,255,207,12,0,0,0,0,0,151,253,254,232,73,0,0,1,0,1,0,0,0,0,0,0,0,0,0,0,0,0,120,246,255,252,161,0,0,0,0,104,239,255,254,178,0,0,0,0,0,0,0,0,0,0,0,0,0,0,0,0,0,0,13,187,254,255,254,214,165,162,192,247,255,255,227,73,0,0,0,0,1,0,0,0,0,0,0,0,1,0,0,0,0,0,0,42,192,254,254,255,255,255,255,255,255,227,93,0,0,0,0,0,0,0,1,0,0,0,0,0,0,1,0,0,0,1,0,0,0,115,208,244,255,255,251,224,155,28,0,0,0,0,0,0,0,0,0,0,0,0,0,1,0,0,0,0,0,0,0,0,0,0,0,0,0,0,0,1,0,0,1,0,0,0,0,0,0,0,0,0,0,0,0,0,0,0,0,0,0,0,0,1,0,0,0,0,0,0,0,0,1,0,0,0,0,0,0,0,0,0,0,0,0,0,0,0,0,0,1,0,0,0,0,0,0,0,0,0,0,0,0,0,0,0,0,0,0,0,0,0,0,1,0,0,0,0,0,0,0,0,0,0,0,0,0,0,0,1,0,0,0,0,0,0,1,0,0,0,0,0,0,0,0,0,0,0,0,0,0,0,0,0,0,0,0,0,0,0,0,0,0,0,0,1,0,0,0,0,0,0,1,0,0,1,0,0,0,0,0,0,0,0,0,0,0,0,0,0,0,0,0,0,0,0,0,0,0,0,0,0,0,1,0,0,1,0,0,0,0,0,0,0,0,0,0,0,0,0,0,0,0,0,0,0,0,0,0,0,0,0,0,0,0,0,0,0,0,0,0,0,0,0,0,0,0,0,0,0,0,0,0,0,0,0,0,0,0,0,0,0,0,0,0,0,0,0,0,0,0,0,0,0,0,0,0,};
unsigned char turkish_c[]
{0,1,1,1,0,0,0,0,0,0,0,0,0,1,0,0,0,0,0,0,0,0,1,0,0,0,0,0,0,0,0,0,0,0,1,0,0,0,0,0,0,0,0,0,0,0,0,0,0,0,0,0,0,0,1,0,1,0,0,0,0,0,0,0,0,0,0,0,0,0,0,0,0,0,0,0,0,0,0,0,0,0,0,0,0,0,0,0,0,0,0,0,0,0,0,0,0,0,0,0,0,0,0,0,0,0,0,0,0,0,0,0,1,0,0,0,0,0,1,0,1,0,0,0,0,0,0,0,0,0,1,0,0,0,0,0,0,0,0,0,0,1,0,0,1,1,0,0,0,0,0,0,0,0,0,0,0,0,0,0,1,1,0,0,0,0,0,0,0,0,0,0,0,0,0,0,0,0,0,0,0,0,0,0,0,0,0,0,0,0,0,0,0,0,0,1,0,0,0,0,0,1,0,0,0,1,0,0,0,1,0,0,0,0,0,0,0,0,0,0,1,0,0,0,0,0,0,1,0,0,0,0,0,0,0,0,0,42,156,225,248,255,255,248,224,156,42,0,0,0,0,0,0,0,0,0,1,0,0,0,0,0,0,0,0,0,0,0,132,240,254,255,255,255,255,255,255,255,224,61,0,0,0,0,0,0,0,0,0,0,1,0,0,0,0,0,0,0,0,133,247,255,255,242,190,162,162,174,226,254,228,66,0,0,0,0,0,0,0,0,0,1,0,0,0,0,0,0,0,0,98,238,255,254,195,42,0,0,0,0,0,119,205,67,0,0,0,0,0,0,0,0,0,0,0,0,0,0,0,0,0,0,180,255,254,212,42,0,1,0,0,0,0,0,28,13,0,0,0,0,0,0,0,1,1,0,0,0,0,0,0,0,0,66,228,255,251,136,0,0,1,0,0,0,0,0,0,0,0,0,0,0,0,0,0,0,1,0,0,0,0,0,0,0,0,108,244,255,233,77,0,0,1,0,0,0,0,0,0,0,0,0,0,0,0,0,0,0,1,0,0,0,0,1,0,1,0,130,249,255,227,61,0,0,0,0,0,0,0,0,0,0,1,0,0,0,0,0,0,0,0,0,0,0,0,0,0,0,0,130,249,255,212,0,0,0,0,0,0,0,0,1,0,0,0,0,0,0,0,1,1,0,1,0,0,0,0,0,1,0,0,130,249,254,227,61,0,0,0,1,0,0,0,0,0,0,0,1,0,0,1,0,0,0,0,0,0,0,1,0,0,0,0,98,243,254,233,77,0,0,0,0,0,0,0,0,0,0,0,0,0,0,0,0,0,0,0,0,0,0,0,0,0,0,0,66,228,255,250,136,0,1,0,0,0,0,0,0,1,0,0,0,0,0,0,0,0,0,0,0,0,0,0,0,0,0,0,0,180,255,255,212,42,0,0,0,0,0,0,0,0,0,0,0,0,0,0,0,0,0,1,0,0,0,0,0,0,0,0,0,88,236,255,254,195,56,0,0,0,0,0,88,185,66,1,0,0,0,0,0,0,0,0,0,0,0,0,0,0,0,0,0,0,133,247,255,255,242,190,162,162,168,217,253,228,66,0,0,0,0,0,0,0,0,0,0,0,1,0,0,0,0,0,0,0,0,132,240,255,255,255,255,255,255,255,255,227,61,0,0,0,0,0,0,0,0,0,0,0,0,0,0,0,0,0,0,0,0,0,42,156,224,246,255,255,248,225,157,42,0,0,0,0,0,0,0,0,0,0,0,0,0,0,0,0,0,0,0,0,0,0,0,0,0,0,169,253,167,0,0,0,0,0,0,0,0,0,0,0,0,0,0,0,0,0,0,0,0,0,0,0,0,0,0,0,0,0,56,222,246,120,0,1,0,0,0,0,0,0,0,0,0,0,0,0,0,0,0,0,0,0,0,0,0,0,0,0,0,0,0,188,255,194,0,0,0,0,0,0,0,1,0,0,0,0,0,0,0,0,0,0,0,1,0,0,0,0,0,176,169,162,176,242,255,213,0,0,0,0,0,0,0,0,0,0,0,0,0,1,0,0,0,0,0,0,1,0,0,0,0,213,255,255,255,255,254,166,0,0,0,0,0,0,0,0,0,0,0,0,0,0,0,0,0,1,0,0,0,0,0,0,0,184,243,254,255,243,175,28,0,1,0,0,0,0,0,0,0,0,0,0,0,0,1,0,0,0,0,0,0,0,0,0,0,0,0,0,0,0,0,0,0,1,0,0,0,0,0,0,0,0,0,0,0,0,0,0,0,0,0,0,0,0,0,0,1,0,0,0,0,0,0,0,0,0,0,0,0,0,1,1,0,1,0,};